########
#  @  X#
#A @  X#
#      #
########