########
#  @  X#
#     A#
#     @#
########
*########
#     X#
#     X#
#      #
########
