########
#  @  X#
#   A@X#
#      #
########
*########
#      #
#      #
#      #
########
